3 3 3 3 3 3 3 3 3 3 3 3 3 3 3 3
3 0 0 0 0 0 0 0 0 0 0 0 0 0 0 0
3 0 0 0 0 0 0 0 0 0 2 2 2 2 2 2
3 0 0 0 0 0 0 0 0 2 2 2 2 2 2 2
3 0 0 0 0 0 0 0 0 0 0 2 2 2 2 2
3 0 0 0 0 0 0 0 0 0 0 0 0 0 0 0
3 0 0 0 0 0 0 0 0 0 0 0 0 0 0 0
5 5 5 5 0 0 0 0 0 0 0 5 5 5 5 5
4 4 5 5 5 5 5 5 5 5 5 5 5 5 4 6
6 6 4 4 4 4 5 5 5 5 5 5 5 4 6 6
6 6 6 6 6 6 4 4 4 4 4 4 4 4 6 6
6 6 6 6 6 6 6 6 6 6 6 6 6 6 6 6